"pitdrone/pit_drone_attack_spike1.wav"	"debris/glass1.wav"
"pitdrone/pit_drone_attack_spike2.wav"	"debris/glass3.wav"
"pitdrone/pit_drone_alert1.wav"	"debris/bustglass1.wav"
"pitdrone/pit_drone_alert2.wav"	"debris/bustglass2.wav"
"pitdrone/pit_drone_alert3.wav"	"debris/bustglass3.wav"
"pitdrone/pit_drone_die1.wav"	"debris/bustglass1.wav"
"pitdrone/pit_drone_die2.wav"	"debris/bustglass2.wav"
"pitdrone/pit_drone_die3.wav"	"debris/bustglass3.wav"
"pitdrone/pit_drone_pain1.wav"	"debris/glass3.wav"
"pitdrone/pit_drone_pain2.wav"	"debris/glass3.wav"
"pitdrone/pit_drone_pain3.wav"	"debris/glass3.wav"
"pitdrone/pit_drone_pain4.wav"	"debris/glass3.wav"
"pitdrone/pit_drone_melee_attack1.wav"	"debris/glass3.wav"
"pitdrone/pit_drone_melee_attack2.wav"	"debris/glass4.wav"
"pitdrone/pit_drone_eat.wav"	"debris/glass1.wav"
"pitdrone/pit_drone_hunt1.wav"	"debris/glass1.wav"
"pitdrone/pit_drone_hunt2.wav"	"debris/glass2.wav"
"pitdrone/pit_drone_hunt3.wav"	"debris/glass3.wav"
"pitdrone/pit_drone_idle1.wav"	"debris/glass3.wav"
"pitdrone/pit_drone_idle2.wav"	"debris/glass2.wav"
"pitdrone/pit_drone_idle3.wav"	"debris/glass1.wav"
"pitdrone/pit_drone_communicate1.wav"	"debris/bustglass3.wav"
"pitdrone/pit_drone_communicate2.wav"	"debris/bustglass1.wav"
"pitdrone/pit_drone_communicate3.wav"	"debris/bustglass2.wav"
"pitdrone/pit_drone_communicate4.wav"	"debris/bustglass3.wav"